Time, File, Conversion, Render, Resize, Total, Status
3/12/2019 4:37:24 PM, 100SlidePowerPointPres.ppt, 2546, 2, 22, 2570, Ok
3/12/2019 4:37:24 PM, 131814.xls, 379, 1, 7, 387, Ok
3/12/2019 4:37:25 PM, 1excel 2003.xls, 59, 1, 22, 82, Ok
3/12/2019 4:37:25 PM, 1PPT 2003.ppt, 199, 2, 22, 223, Ok
3/12/2019 4:37:25 PM, 1PPTX 2003.pot, 181, 2, 22, 205, Ok
3/12/2019 4:37:25 PM, 1Read only excel 2003.xls, 27, 1, 22, 50, Ok
3/12/2019 4:37:26 PM, 1Read Only Word 2003.doc, 682, 2, 2, 686, Ok
3/12/2019 4:37:26 PM, 1Template excel 2003.xlt, 0, 0, 0, 0, Error
3/12/2019 4:37:26 PM, 1Word 2003 template.dot, 69, 2, 2, 73, Ok
3/12/2019 4:37:26 PM, 1Word 2003.doc, 48, 1, 2, 51, Ok
3/12/2019 4:37:26 PM, 2003PowerPointPres.PPT, 135, 1, 22, 158, Ok
3/12/2019 4:37:26 PM, 2016 32bit file_colors.docx, 64, 1, 2, 67, Ok
3/12/2019 4:37:28 PM, 2016 32bit file_colors_111.odt, 1335, 2, 3, 1340, Ok
3/12/2019 4:37:28 PM, 2018.05.25.00.03.04(1).xlsx, 109, 1, 16, 126, Ok
3/12/2019 4:37:28 PM, 2018.05.25.00.03.04.xlsx, 55, 2, 15, 72, Ok
3/12/2019 4:37:28 PM, 29 pages.docx, 483, 2, 2, 487, Ok
3/12/2019 4:37:29 PM, 3 - PrepareForMigration.ppsx, 253, 2, 24, 279, Ok
3/12/2019 4:37:36 PM, 3_original.xls, 7197, 0, 20, 7217, Ok
3/12/2019 4:37:43 PM, 479 Pages.doc, 7520, 0, 2, 7522, Ok
3/12/2019 4:37:43 PM, 4_original.xlsx, 4, 0, 21, 25, Ok
3/12/2019 4:37:44 PM, 5_original_2007template.xltx, 144, 0, 8, 152, Ok
3/12/2019 4:37:57 PM, 719 Pages.doc, 13488, 0, 2, 13490, Ok
3/12/2019 4:37:57 PM, all keyboard chars.DOC, 19, 0, 2, 21, Ok
3/12/2019 4:39:02 PM, Big document.doc, 65314, 0, 20, 65334, Ok
3/12/2019 4:39:03 PM, Binary2016.xlsx, 39, 0, 24, 63, Ok
3/12/2019 4:39:03 PM, Buddy Requirement.DOC, 271, 0, 2, 273, Ok
3/12/2019 4:39:03 PM, Calorie amortization schedule1.xlsx, 413, 0, 52, 465, Ok
3/12/2019 4:39:03 PM, ClaimsAdmin.pptx, 142, 0, 24, 166, Ok
3/12/2019 4:39:04 PM, ClaimsAdmin2016.pptx, 63, 0, 24, 87, Ok
3/12/2019 4:39:04 PM, ColoredFonts.xlsx, 4, 0, 20, 24, Ok
3/12/2019 4:39:04 PM, ColoredFonts.zip, 0, 0, 0, 0, Error
3/12/2019 4:39:04 PM, created by pam - readonly - final.docx, 33, 0, 3, 36, Ok
3/12/2019 4:39:04 PM, DOC 2013.doc, 62, 0, 2, 64, Ok
3/12/2019 4:39:04 PM, DOCM 2013.docm, 137, 0, 3, 140, Ok
3/12/2019 4:39:22 PM, Document less 5mb-2013.dotm, 17876, 0, 19, 17895, Ok
3/12/2019 4:39:22 PM, Document Preview-2013.xlsx, 93, 0, 29, 122, Ok
3/12/2019 4:39:22 PM, DOCX 2013.docx, 111, 0, 2, 113, Ok
3/12/2019 4:39:24 PM, DOT 2013.dot, 1482, 0, 2, 1484, Ok
3/12/2019 4:39:24 PM, DOTM 2013.dotm, 751, 0, 2, 753, Ok
3/12/2019 4:39:24 PM, DOTX 2013.dotx, 80, 0, 2, 82, Ok
3/12/2019 4:39:24 PM, EmptyDoc 2003.doc, 14, 0, 2, 16, Ok
3/12/2019 4:39:24 PM, Emptyexcel2003.xls, 24, 0, 7, 31, Ok
3/12/2019 4:39:24 PM, emptyexceltemplate2003.xlt, 0, 0, 0, 0, Error
3/12/2019 4:39:24 PM, emptyppt.ppt, 9, 0, 22, 31, Ok
3/12/2019 4:39:46 PM, Entire_Gutenberg_Twain_Texts.rtf, 21383, 0, 2, 21385, Ok
3/12/2019 4:39:46 PM, excel 2003.xls, 41, 0, 23, 64, Ok
3/12/2019 4:39:46 PM, Excel 2007 read only.xlsx, 62, 0, 8, 70, Ok
3/12/2019 4:39:46 PM, Excel 2007 template.xltm, 51, 0, 8, 59, Ok
3/12/2019 4:39:46 PM, Excel 2007 template.xltx, 43, 0, 8, 51, Ok
3/12/2019 4:39:46 PM, Excel 2007.xlsb, 0, 0, 0, 0, Error
3/12/2019 4:39:46 PM, Excel 2007.xlsm, 40, 0, 8, 48, Ok
3/12/2019 4:39:46 PM, Excel 2007.xlsx, 50, 0, 8, 58, Ok
3/12/2019 4:39:46 PM, excel 2010.xlsb, 0, 0, 0, 0, Error
3/12/2019 4:39:46 PM, excel 2010.xlsm, 20, 0, 22, 42, Ok
3/12/2019 4:39:46 PM, excel 2010.xlsx, 22, 0, 24, 46, Ok
3/12/2019 4:39:46 PM, excel 2016.xlsx, 17, 0, 22, 39, Ok
3/12/2019 4:39:47 PM, excel 2016_1page.xls, 49, 0, 8, 57, Ok
3/12/2019 4:39:47 PM, excel1 2003.XLS, 27, 0, 25, 52, Ok
3/12/2019 4:39:47 PM, Excel1 2007 template.XLTM, 43, 0, 8, 51, Ok
3/12/2019 4:39:47 PM, Excel1 2007.XLSM, 47, 0, 9, 56, Ok
3/12/2019 4:39:47 PM, excel1 2010.XLSB, 0, 0, 0, 0, Error
3/12/2019 4:39:47 PM, excel2013_empty.xlsx, 6, 0, 8, 14, Ok
3/12/2019 4:39:48 PM, Excel_5worksheets_500rows.xls, 736, 0, 35, 771, Ok
3/12/2019 4:39:48 PM, Excel_5worksheets_500rows.xlsx, 496, 0, 32, 528, Ok
3/12/2019 4:39:48 PM, given_simple_pp_macro_template.POTM, 13, 0, 24, 37, Ok
3/12/2019 4:39:48 PM, given_simple_pp_template.POTX, 16, 0, 24, 40, Ok
3/12/2019 4:39:48 PM, ImageRight MINT POC Issues-2013.xlt, 0, 0, 0, 0, Error
3/12/2019 4:39:48 PM, ImageRightFaxCover.dot, 97, 0, 2, 99, Ok
3/12/2019 4:39:51 PM, IR Viewer Retail-2013.potx, 2377, 0, 23, 2400, Ok
3/12/2019 4:39:51 PM, IR Viewer Retail-2013.ppsx, 94, 0, 24, 118, Ok
3/12/2019 4:39:53 PM, IR Viewer Retail-2013.pptm, 2129, 0, 23, 2152, Ok
3/12/2019 4:39:53 PM, IR Viewer Retail-2013.pptx, 43, 0, 26, 69, Ok
3/12/2019 4:39:55 PM, Large.xlsx, 1451, 0, 20, 1471, Ok
3/12/2019 4:39:59 PM, LargeBook1.xlsx, 4597, 0, 45, 4642, Ok
3/12/2019 4:39:59 PM, Macro 2016.xlsm, 41, 0, 25, 66, Ok
3/12/2019 4:39:59 PM, macro2016.pptm, 69, 2, 24, 95, Ok
3/12/2019 4:40:00 PM, Macroword 2016.docm, 479, 2, 2, 483, Ok
3/12/2019 4:40:00 PM, Mad kitty.docx, 41, 2, 2, 45, Ok
3/12/2019 4:40:00 PM, OCR FAQ - 2013.dotx, 75, 2, 2, 79, Ok
3/12/2019 4:40:00 PM, OCR Workflow Scripting-2013.docm, 65, 3, 4, 72, Ok
3/12/2019 4:40:00 PM, POT 2013.pot, 209, 3, 30, 242, Ok
3/12/2019 4:40:01 PM, POTM 2013.potm, 53, 2, 24, 79, Ok
3/12/2019 4:40:03 PM, POTX 2013.potx, 2455, 2, 24, 2481, Ok
3/12/2019 4:40:03 PM, powerpoint file in ppSm (show .PPSM, 140, 2, 23, 165, Ok
3/12/2019 4:40:03 PM, powerpoint file in ppSm (show macro)format.ppsm, 113, 2, 22, 137, Ok
3/12/2019 4:40:04 PM, powerpoint file in ppSx (show )format.ppsx, 120, 2, 22, 144, Ok
3/12/2019 4:40:04 PM, powerpoint file in ppSx (show .PPSX, 128, 2, 22, 152, Ok
3/12/2019 4:40:04 PM, powerpoint file in pptm (macro)format.pptm, 118, 2, 23, 143, Ok
3/12/2019 4:40:04 PM, powerpoint file in pptm (macro.PPTM, 124, 2, 23, 149, Ok
3/12/2019 4:40:04 PM, powerpoint file in pptx format.pptx, 126, 2, 23, 151, Ok
3/12/2019 4:40:05 PM, PPS.pps, 484, 2, 23, 509, Ok
3/12/2019 4:40:05 PM, PPSM 2013.ppsm, 225, 0, 24, 249, Ok
3/12/2019 4:40:05 PM, PPSX 2013.ppsx, 96, 0, 25, 121, Ok
3/12/2019 4:40:06 PM, PPT 2003 read-only.ppt, 452, 0, 22, 474, Ok
3/12/2019 4:40:06 PM, PPT 2003.ppt, 159, 0, 22, 181, Ok
3/12/2019 4:40:06 PM, PPT 2013.ppt, 321, 0, 25, 346, Ok
3/12/2019 4:40:06 PM, PPT2013_empty.pptx, 13, 0, 27, 40, Ok
3/12/2019 4:40:06 PM, PPTM.pptm, 48, 0, 24, 72, Ok
3/12/2019 4:40:07 PM, PPTX 2003.POT, 170, 0, 24, 194, Ok
3/12/2019 4:40:07 PM, PPTX 2007.pptm, 89, 0, 22, 111, Ok
3/12/2019 4:40:07 PM, PPTX 2007.pptx, 91, 0, 22, 113, Ok
3/12/2019 4:40:07 PM, pptx 2010 - read-only-final.pptx, 56, 2, 24, 82, Ok
3/12/2019 4:40:07 PM, pptx 2010.pptm, 49, 2, 23, 74, Ok
3/12/2019 4:40:07 PM, pptx 2010.pptx, 46, 3, 26, 75, Ok
3/12/2019 4:40:07 PM, PPTX 2013.pptx, 120, 2, 25, 147, Ok
3/12/2019 4:40:07 PM, Print Screen.doc, 35, 2, 2, 39, Ok
3/12/2019 4:40:08 PM, Read only excel 2003.xls, 34, 2, 23, 59, Ok
3/12/2019 4:40:08 PM, read only excel 2010.xlsx, 31, 2, 26, 59, Ok
3/12/2019 4:40:08 PM, read only excel 2016.xlsx, 22, 2, 23, 47, Ok
3/12/2019 4:40:08 PM, Read only excel1 2003.XLS, 32, 5, 25, 62, Ok
3/12/2019 4:40:08 PM, Read Only Word 2003.doc, 69, 2, 2, 73, Ok
3/12/2019 4:40:08 PM, read only word 2010.docx, 108, 2, 2, 112, Ok
3/12/2019 4:40:08 PM, read only word 2016.docx, 111, 1, 2, 114, Ok
3/12/2019 4:40:08 PM, Read-only-2013.xlsx, 58, 2, 8, 68, Ok
3/12/2019 4:40:08 PM, read-only-YN-2013.docm, 164, 2, 2, 168, Ok
3/12/2019 4:40:08 PM, read-only2016.pptx, 58, 3, 28, 89, Ok
3/12/2019 4:40:08 PM, readonly.docx, 23, 2, 3, 28, Ok
3/12/2019 4:40:09 PM, RTF 2013.rtf, 637, 3, 4, 644, Ok
3/12/2019 4:40:09 PM, Scenarios-2013.xlsm, 137, 3, 19, 159, Ok
3/12/2019 4:40:10 PM, SimpleExcelWorksheet.xlsx, 234, 2, 25, 261, Ok
3/12/2019 4:40:10 PM, Template excel 2003.xlt, 0, 0, 0, 0, Error
3/12/2019 4:40:10 PM, Template excel1 2003.XLT, 0, 0, 0, 0, Error
3/12/2019 4:40:10 PM, Test FIle.xltx, 6, 2, 21, 29, Ok
3/12/2019 4:40:10 PM, TEST-MULTIPAGE.docx, 49, 2, 2, 53, Ok
3/12/2019 4:40:10 PM, TEST.docx, 18, 2, 2, 22, Ok
3/12/2019 4:40:10 PM, test.xlsx, 3, 3, 21, 27, Ok
3/12/2019 4:40:10 PM, Test1.ppt, 190, 2, 23, 215, Ok
3/12/2019 4:40:10 PM, Test1.xls, 32, 2, 8, 42, Ok
3/12/2019 4:40:10 PM, Test1_2013.pptm, 75, 2, 23, 100, Ok
3/12/2019 4:40:10 PM, Test2.PPT, 164, 2, 23, 189, Ok
3/12/2019 4:40:10 PM, Test2.xls, 10, 2, 20, 32, Ok
3/12/2019 4:40:14 PM, Test3Large.XLS, 3426, 1, 7, 3434, Ok
3/12/2019 4:40:14 PM, This is a docm file.docm, 23, 3, 2, 28, Ok
3/12/2019 4:40:14 PM, This is a great spot for a mission statement-2013.docx, 171, 1, 2, 174, Ok
3/12/2019 4:40:14 PM, Trouble adding Burn Queues.docx, 39, 1, 2, 42, Ok
3/12/2019 4:40:30 PM, twainmaretext02mtent13rtf.rtf, 15951, 2, 7, 15960, Ok
3/12/2019 4:40:39 PM, Waterton Final WS.xls, 8799, 0, 20, 8819, Ok
3/12/2019 4:40:39 PM, Wedding budget1-2013.xlsb, 0, 0, 0, 0, Error
3/12/2019 4:40:39 PM, Werbung_1.PPS, 141, 0, 23, 164, Ok
3/12/2019 4:40:39 PM, Word 2003 read-only-final.DOC, 56, 0, 2, 58, Ok
3/12/2019 4:40:39 PM, Word 2003 template.DOT, 69, 0, 3, 72, Ok
3/12/2019 4:40:39 PM, Word 2003.doc, 52, 0, 2, 54, Ok
3/12/2019 4:40:39 PM, Word 2003.one page.doc, 46, 0, 2, 48, Ok
3/12/2019 4:40:40 PM, Word 2007 read only.docx, 41, 0, 3, 44, Ok
3/12/2019 4:40:40 PM, Word 2007 template.DOTM, 132, 0, 2, 134, Ok
3/12/2019 4:40:40 PM, Word 2007 template.dotx, 24, 0, 2, 26, Ok
3/12/2019 4:40:40 PM, Word 2007.docx, 37, 0, 2, 39, Ok
3/12/2019 4:40:40 PM, Word 2010 Template.DOTX, 16, 0, 2, 18, Ok
3/12/2019 4:40:40 PM, word 2010.docm, 136, 0, 2, 138, Ok
3/12/2019 4:40:40 PM, word 2010.docx, 107, 0, 7, 114, Ok
3/12/2019 4:40:44 PM, Word_250 pages.docx, 3835, 0, 19, 3854, Ok
3/12/2019 4:40:53 PM, Word_500 pages.doc, 9332, 0, 19, 9351, Ok
3/12/2019 4:41:01 PM, Word_500 pages.docx, 7625, 0, 20, 7645, Ok
3/12/2019 4:41:01 PM, XLS 2013.xls, 0, 0, 0, 0, Error
3/12/2019 4:41:01 PM, XLSB 2013.xlsb, 0, 0, 0, 0, Error
3/12/2019 4:41:01 PM, xlsB formated workbook.xlsb, 0, 0, 0, 0, Error
3/12/2019 4:41:01 PM, XLSM 2013.xlsm, 126, 0, 23, 149, Ok
3/12/2019 4:41:01 PM, xlsM formated workbook.xlsm, 11, 0, 20, 31, Ok
3/12/2019 4:41:01 PM, XLT 2013.xlt, 0, 0, 0, 0, Error
3/12/2019 4:41:01 PM, XLTM 2013.xltm, 30, 0, 20, 50, Ok
3/12/2019 4:41:01 PM, XLTX 2013.xltx, 34, 0, 9, 43, Ok
3/12/2019 4:41:01 PM, XSLX 2016.xlsx, 138, 0, 12, 150, Ok
